เรา	r a w^
เรา	l a w^
ความคิดเห็น	khw aa m^ kh i t^ h e n^
อม	z o m^
สี่	s ii
ดู	d uu
คน	kh o n^
ของ	kh @@ ng^
แชร์	ch xx
เพจ	ph ee t^
เพจ	ph e t^
ที่	th ii
ไป	p a j^
อะ	z a
เท่าไหร่	th a w^ r a j^
กี่	k ii
มี	m ii
สาม	s aa m^
เวลา	w ee l aa
หน้า	n aa
ครับ	khr a p^
ครับ	kh a p^
ละ	l a
แสดง	s a d xx ng^
เฟซ	f ee t^ s
เฟซ	f ee t^
เฟซ	f ee s
ขอ	kh @@
มีคน	m ii kh o n^
กลับ	kl a p^
ไหน	n a j^
ความรู้สึก	khw aa m^ r uu s v k^
สัตว์	s a t^
เพื่อน	ph vva n^
หน่อย	n @ j^
ถูกใจ	th uu k^ c a j^
อ่ะ	z a
ไว้	w a j^
ชอบ	ch @@ p^
หนังสือ	n a ng^ s vv
สิ	s i
บ้าง	b aa ng^
เล่น	l e n^
ใช้	ch a j^
จำนวน	c a m^ n uua n^
ห้า	h aa
สอง	s @@ ng^
ศิลปิน	s i n^ l a p i n^
หรอ	r qq
โลก	l oo k^
หนึ่ง	n v ng^
แล้ว	l xx w^
เช็คอิน	ch e kh @@ qq n^
อะไร	z a r a j^
นะ	n a
โพสต์	ph oo t^
โพสต์	ph oo t^ s
เฟซบุค	f ee s b u k^
เฟซบุค	f ee t^ s b u k^
ตีน	t ii n^
ล่าสุด	l aa s u t^
